"filename", "language", "YAML", "Go", "Go Module File", "Go Checksum File", "Protocol Buffers", "comment", "blank", "total"
"/data/home/ziruigao/src/mini-game-router-v1/core/balancer/balancerPrototype.go", "Go", 0, -55, 0, 0, 0, 0, -8, -63
"/data/home/ziruigao/src/mini-game-router-v1/core/balancer/consistentHashBalancer.go", "Go", 0, -91, 0, 0, 0, 0, -19, -110
"/data/home/ziruigao/src/mini-game-router-v1/core/balancer/dynamicBalancer.go", "Go", 0, -55, 0, 0, 0, 0, -15, -70
"/data/home/ziruigao/src/mini-game-router-v1/core/balancer/myPicker.go", "Go", 0, -93, 0, 0, 0, 0, -12, -105
"/data/home/ziruigao/src/mini-game-router-v1/core/balancer/randomBalancer.go", "Go", 0, -42, 0, 0, 0, 0, -14, -56
"/data/home/ziruigao/src/mini-game-router-v1/core/balancer/staticBalancer.go", "Go", 0, -52, 0, 0, 0, 0, -15, -67
"/data/home/ziruigao/src/mini-game-router-v1/core/balancer/weightBalancer.go", "Go", 0, -60, 0, 0, 0, 0, -17, -77
"/data/home/ziruigao/src/mini-game-router-v1/core/config/config.go", "Go", 0, -133, 0, 0, 0, 0, -23, -156
"/data/home/ziruigao/src/mini-game-router-v1/core/etcd/discovery.go", "Go", 0, -72, 0, 0, 0, 0, -14, -86
"/data/home/ziruigao/src/mini-game-router-v1/core/etcd/register.go", "Go", 0, -74, 0, 0, 0, 0, -10, -84
"/data/home/ziruigao/src/mini-game-router-v1/core/init/init.go", "Go", 0, -19, 0, 0, 0, 0, -4, -23
"/data/home/ziruigao/src/mini-game-router-v1/core/metrics/clientMetrics.go", "Go", 0, -48, 0, 0, 0, 0, -13, -61
"/data/home/ziruigao/src/mini-game-router-v1/core/metrics/serverMetrics.go", "Go", 0, -34, 0, 0, 0, 0, -11, -45
"/data/home/ziruigao/src/mini-game-router-v1/core/netToolkit/netToolkit.go", "Go", 0, -86, 0, 0, 0, 0, -18, -104
"/data/home/ziruigao/src/mini-game-router-v1/core/resolver/myResolver.go", "Go", 0, -70, 0, 0, 0, 0, -13, -83
"/data/home/ziruigao/src/mini-game-router-v1/core/router/router.go", "Go", 0, -161, 0, 0, 0, 0, -23, -184
"/data/home/ziruigao/src/mini-game-router-v1/core/tools/randomPickMap.go", "Go", 0, -52, 0, 0, 0, 0, -13, -65
"/data/home/ziruigao/src/mini-game-router-v1/demo/client/client.go", "Go", 0, -103, 0, 0, 0, 0, -15, -118
"/data/home/ziruigao/src/mini-game-router-v1/demo/control/control.go", "Go", 0, -41, 0, 0, 0, 0, -8, -49
"/data/home/ziruigao/src/mini-game-router-v1/demo/server/server.go", "Go", 0, -75, 0, 0, 0, 0, -15, -90
"/data/home/ziruigao/src/mini-game-router-v1/go.mod", "Go Module File", 0, 0, -35, 0, 0, 0, -6, -41
"/data/home/ziruigao/src/mini-game-router-v1/go.sum", "Go Checksum File", 0, 0, 0, -103, 0, 0, -1, -104
"/data/home/ziruigao/src/mini-game-router-v1/proto/hello.pb.go", "Go", 0, -185, 0, 0, 0, 0, -26, -211
"/data/home/ziruigao/src/mini-game-router-v1/proto/hello.proto", "Protocol Buffers", 0, 0, 0, 0, -12, 0, -4, -16
"/data/home/ziruigao/src/mini-game-router-v1/proto/hello_grpc.pb.go", "Go", 0, -95, 0, 0, 0, 0, -16, -111
"/data/home/ziruigao/src/mini-game-router-v1/test/test.go", "Go", 0, -40, 0, 0, 0, 0, -3, -43
"/data/home/ziruigao/src/mini-game-router/cmd/control/control.go", "Go", 0, 55, 0, 0, 0, 0, 9, 64
"/data/home/ziruigao/src/mini-game-router/cmd/demo-tcp/client/client.go", "Go", 0, 161, 0, 0, 0, 0, 24, 185
"/data/home/ziruigao/src/mini-game-router/cmd/demo-tcp/server/server.go", "Go", 0, 91, 0, 0, 0, 0, 17, 108
"/data/home/ziruigao/src/mini-game-router/cmd/demo/client/client.go", "Go", 0, 126, 0, 0, 0, 0, 20, 146
"/data/home/ziruigao/src/mini-game-router/cmd/demo/server/server.go", "Go", 0, 93, 0, 0, 0, 0, 17, 110
"/data/home/ziruigao/src/mini-game-router/config/clientConfig.yaml", "YAML", 38, 0, 0, 0, 0, 1, 0, 39
"/data/home/ziruigao/src/mini-game-router/config/serverConfig.yaml", "YAML", 45, 0, 0, 0, 0, 1, 0, 46
"/data/home/ziruigao/src/mini-game-router/core/balancer/consistentHashBalancer.go", "Go", 0, 99, 0, 0, 0, 0, 25, 124
"/data/home/ziruigao/src/mini-game-router/core/balancer/dynamicBalancer.go", "Go", 0, 101, 0, 0, 0, 0, 19, 120
"/data/home/ziruigao/src/mini-game-router/core/balancer/myBalancer.go", "Go", 0, 56, 0, 0, 0, 0, 14, 70
"/data/home/ziruigao/src/mini-game-router/core/balancer/myPicker.go", "Go", 0, 60, 0, 0, 0, 0, 9, 69
"/data/home/ziruigao/src/mini-game-router/core/balancer/randomBalancer.go", "Go", 0, 50, 0, 0, 0, 0, 16, 66
"/data/home/ziruigao/src/mini-game-router/core/balancer/staticBalancer.go", "Go", 0, 60, 0, 0, 0, 0, 18, 78
"/data/home/ziruigao/src/mini-game-router/core/balancer/weightBalancer.go", "Go", 0, 70, 0, 0, 0, 0, 22, 92
"/data/home/ziruigao/src/mini-game-router/core/cache/cache.go", "Go", 0, 31, 0, 0, 0, 0, 9, 40
"/data/home/ziruigao/src/mini-game-router/core/cache/lru.go", "Go", 0, 64, 0, 0, 0, 0, 13, 77
"/data/home/ziruigao/src/mini-game-router/core/config/config.go", "Go", 0, 164, 0, 0, 0, 0, 29, 193
"/data/home/ziruigao/src/mini-game-router/core/etcd/discovery.go", "Go", 0, 199, 0, 0, 0, 0, 28, 227
"/data/home/ziruigao/src/mini-game-router/core/etcd/register.go", "Go", 0, 114, 0, 0, 0, 0, 16, 130
"/data/home/ziruigao/src/mini-game-router/core/metrics/clientMetrics.go", "Go", 0, 40, 0, 0, 0, 0, 11, 51
"/data/home/ziruigao/src/mini-game-router/core/metrics/serverMetrics.go", "Go", 0, 69, 0, 0, 0, 0, 17, 86
"/data/home/ziruigao/src/mini-game-router/core/netToolkit/netToolkit.go", "Go", 0, 127, 0, 0, 0, 0, 21, 148
"/data/home/ziruigao/src/mini-game-router/core/resolver/myResolver.go", "Go", 0, 64, 0, 0, 0, 0, 13, 77
"/data/home/ziruigao/src/mini-game-router/core/router/router.go", "Go", 0, 198, 0, 0, 0, 0, 31, 229
"/data/home/ziruigao/src/mini-game-router/core/sdk/sdk.go", "Go", 0, 95, 0, 0, 0, 0, 19, 114
"/data/home/ziruigao/src/mini-game-router/core/tools/rand.go", "Go", 0, 46, 0, 0, 0, 0, 8, 54
"/data/home/ziruigao/src/mini-game-router/core/tools/randomPickMap.go", "Go", 0, 58, 0, 0, 0, 0, 15, 73
"/data/home/ziruigao/src/mini-game-router/deploy/clientConfig.yaml", "YAML", 45, 0, 0, 0, 0, 1, 0, 46
"/data/home/ziruigao/src/mini-game-router/deploy/docker-compose.yml", "YAML", 37, 0, 0, 0, 0, 156, 2, 195
"/data/home/ziruigao/src/mini-game-router/deploy/grafana-conf/datasources.yml", "YAML", 7, 0, 0, 0, 0, 0, 0, 7
"/data/home/ziruigao/src/mini-game-router/deploy/prometheus.yml", "YAML", 13, 0, 0, 0, 0, 3, 0, 16
"/data/home/ziruigao/src/mini-game-router/deploy/serverConfig.yaml", "YAML", 45, 0, 0, 0, 0, 1, 0, 46
"/data/home/ziruigao/src/mini-game-router/go.mod", "Go Module File", 0, 0, 76, 0, 0, 0, 7, 83
"/data/home/ziruigao/src/mini-game-router/go.sum", "Go Checksum File", 0, 0, 0, 225, 0, 0, 1, 226
"/data/home/ziruigao/src/mini-game-router/proto/hello.pb.go", "Go", 0, 185, 0, 0, 0, 0, 26, 211
"/data/home/ziruigao/src/mini-game-router/proto/hello.proto", "Protocol Buffers", 0, 0, 0, 0, 12, 0, 4, 16
"/data/home/ziruigao/src/mini-game-router/proto/hello_grpc.pb.go", "Go", 0, 95, 0, 0, 0, 0, 16, 111
"/data/home/ziruigao/src/mini-game-router/test/test.go", "Go", 0, 16, 0, 0, 0, 0, 5, 21
"Total", "-", 230, 851, 41, 122, 0, 163, 165, 1572