"filename", "language", "YAML", "Go", "comment", "blank", "total"
"/data/home/ziruigao/src/mini-game-router/cmd/control/control.go", "Go", 0, 19, 0, 2, 21
"/data/home/ziruigao/src/mini-game-router/cmd/demo/client/client.go", "Go", 0, 14, 0, 0, 14
"/data/home/ziruigao/src/mini-game-router/cmd/demo/server/server.go", "Go", 0, -9, 0, -1, -10
"/data/home/ziruigao/src/mini-game-router/config/clientConfig.yaml", "YAML", 2, 0, 0, 0, 2
"/data/home/ziruigao/src/mini-game-router/config/serverConfig.yaml", "YAML", 3, 0, 0, 0, 3
"/data/home/ziruigao/src/mini-game-router/core/balancer/consistentHashBalancer.go", "Go", 0, -4, 0, 0, -4
"/data/home/ziruigao/src/mini-game-router/core/balancer/dynamicBalancer.go", "Go", 0, 3, 0, 0, 3
"/data/home/ziruigao/src/mini-game-router/core/balancer/myPicker.go", "Go", 0, 9, 0, 1, 10
"/data/home/ziruigao/src/mini-game-router/core/balancer/randomBalancer.go", "Go", 0, -5, 0, 0, -5
"/data/home/ziruigao/src/mini-game-router/core/balancer/staticBalancer.go", "Go", 0, -5, 0, -1, -6
"/data/home/ziruigao/src/mini-game-router/core/balancer/weightBalancer.go", "Go", 0, -5, 0, -1, -6
"/data/home/ziruigao/src/mini-game-router/core/config/config.go", "Go", 0, 2, 0, 0, 2
"/data/home/ziruigao/src/mini-game-router/core/etcd/discovery.go", "Go", 0, 34, 0, 6, 40
"/data/home/ziruigao/src/mini-game-router/core/etcd/register.go", "Go", 0, 7, 0, 2, 9
"/data/home/ziruigao/src/mini-game-router/core/router/router.go", "Go", 0, 17, 0, 3, 20
"/data/home/ziruigao/src/mini-game-router/core/sdk/sdk.go", "Go", 0, -1, 0, 0, -1
"/data/home/ziruigao/src/mini-game-router/core/tools/randomPickMap.go", "Go", 0, 4, 0, 0, 4
"/data/home/ziruigao/src/mini-game-router/deploy/clientConfig.yaml", "YAML", -5, 0, 0, 0, -5
"/data/home/ziruigao/src/mini-game-router/deploy/docker-compose.yml", "YAML", 153, 0, -149, 0, 4
"/data/home/ziruigao/src/mini-game-router/deploy/prometheus.yml", "YAML", 3, 0, -3, 0, 0
"/data/home/ziruigao/src/mini-game-router/deploy/serverConfig.yaml", "YAML", 3, 0, 0, 0, 3
"Total", "-", 159, 80, -152, 11, 98