"filename", "language", "Go Checksum File", "Go", "Protocol Buffers", "Go Module File", "YAML", "comment", "blank", "total"
"/data/home/ziruigao/src/mini-game-router/cmd/control/control.go", "Go", 0, 74, 0, 0, 0, 0, 11, 85
"/data/home/ziruigao/src/mini-game-router/cmd/demo-tcp/client/client.go", "Go", 0, 161, 0, 0, 0, 0, 24, 185
"/data/home/ziruigao/src/mini-game-router/cmd/demo-tcp/server/server.go", "Go", 0, 91, 0, 0, 0, 0, 17, 108
"/data/home/ziruigao/src/mini-game-router/cmd/demo/client/client.go", "Go", 0, 140, 0, 0, 0, 0, 20, 160
"/data/home/ziruigao/src/mini-game-router/cmd/demo/server/server.go", "Go", 0, 84, 0, 0, 0, 0, 16, 100
"/data/home/ziruigao/src/mini-game-router/config/clientConfig.yaml", "YAML", 0, 0, 0, 0, 40, 1, 0, 41
"/data/home/ziruigao/src/mini-game-router/config/serverConfig.yaml", "YAML", 0, 0, 0, 0, 48, 1, 0, 49
"/data/home/ziruigao/src/mini-game-router/core/balancer/consistentHashBalancer.go", "Go", 0, 95, 0, 0, 0, 0, 25, 120
"/data/home/ziruigao/src/mini-game-router/core/balancer/dynamicBalancer.go", "Go", 0, 104, 0, 0, 0, 0, 19, 123
"/data/home/ziruigao/src/mini-game-router/core/balancer/myBalancer.go", "Go", 0, 56, 0, 0, 0, 0, 14, 70
"/data/home/ziruigao/src/mini-game-router/core/balancer/myPicker.go", "Go", 0, 69, 0, 0, 0, 0, 10, 79
"/data/home/ziruigao/src/mini-game-router/core/balancer/randomBalancer.go", "Go", 0, 45, 0, 0, 0, 0, 16, 61
"/data/home/ziruigao/src/mini-game-router/core/balancer/staticBalancer.go", "Go", 0, 55, 0, 0, 0, 0, 17, 72
"/data/home/ziruigao/src/mini-game-router/core/balancer/weightBalancer.go", "Go", 0, 65, 0, 0, 0, 0, 21, 86
"/data/home/ziruigao/src/mini-game-router/core/cache/cache.go", "Go", 0, 31, 0, 0, 0, 0, 9, 40
"/data/home/ziruigao/src/mini-game-router/core/cache/lru.go", "Go", 0, 64, 0, 0, 0, 0, 13, 77
"/data/home/ziruigao/src/mini-game-router/core/config/config.go", "Go", 0, 166, 0, 0, 0, 0, 29, 195
"/data/home/ziruigao/src/mini-game-router/core/etcd/discovery.go", "Go", 0, 233, 0, 0, 0, 0, 34, 267
"/data/home/ziruigao/src/mini-game-router/core/etcd/register.go", "Go", 0, 121, 0, 0, 0, 0, 18, 139
"/data/home/ziruigao/src/mini-game-router/core/metrics/clientMetrics.go", "Go", 0, 40, 0, 0, 0, 0, 11, 51
"/data/home/ziruigao/src/mini-game-router/core/metrics/serverMetrics.go", "Go", 0, 69, 0, 0, 0, 0, 17, 86
"/data/home/ziruigao/src/mini-game-router/core/netToolkit/netToolkit.go", "Go", 0, 127, 0, 0, 0, 0, 21, 148
"/data/home/ziruigao/src/mini-game-router/core/resolver/myResolver.go", "Go", 0, 64, 0, 0, 0, 0, 13, 77
"/data/home/ziruigao/src/mini-game-router/core/router/router.go", "Go", 0, 215, 0, 0, 0, 0, 34, 249
"/data/home/ziruigao/src/mini-game-router/core/sdk/sdk.go", "Go", 0, 94, 0, 0, 0, 0, 19, 113
"/data/home/ziruigao/src/mini-game-router/core/tools/rand.go", "Go", 0, 46, 0, 0, 0, 0, 8, 54
"/data/home/ziruigao/src/mini-game-router/core/tools/randomPickMap.go", "Go", 0, 62, 0, 0, 0, 0, 15, 77
"/data/home/ziruigao/src/mini-game-router/deploy/clientConfig.yaml", "YAML", 0, 0, 0, 0, 40, 1, 0, 41
"/data/home/ziruigao/src/mini-game-router/deploy/docker-compose.yml", "YAML", 0, 0, 0, 0, 190, 7, 2, 199
"/data/home/ziruigao/src/mini-game-router/deploy/grafana-conf/datasources.yml", "YAML", 0, 0, 0, 0, 7, 0, 0, 7
"/data/home/ziruigao/src/mini-game-router/deploy/prometheus.yml", "YAML", 0, 0, 0, 0, 16, 0, 0, 16
"/data/home/ziruigao/src/mini-game-router/deploy/serverConfig.yaml", "YAML", 0, 0, 0, 0, 48, 1, 0, 49
"/data/home/ziruigao/src/mini-game-router/go.mod", "Go Module File", 0, 0, 0, 76, 0, 0, 7, 83
"/data/home/ziruigao/src/mini-game-router/go.sum", "Go Checksum File", 225, 0, 0, 0, 0, 0, 1, 226
"/data/home/ziruigao/src/mini-game-router/proto/hello.pb.go", "Go", 0, 185, 0, 0, 0, 0, 26, 211
"/data/home/ziruigao/src/mini-game-router/proto/hello.proto", "Protocol Buffers", 0, 0, 12, 0, 0, 0, 4, 16
"/data/home/ziruigao/src/mini-game-router/proto/hello_grpc.pb.go", "Go", 0, 95, 0, 0, 0, 0, 16, 111
"/data/home/ziruigao/src/mini-game-router/test/test.go", "Go", 0, 16, 0, 0, 0, 0, 5, 21
"Total", "-", 225, 2667, 12, 76, 389, 11, 512, 3892