"filename", "language", "Go Module File", "Go", "Go Checksum File", "comment", "blank", "total"
"/data/home/ziruigao/src/mini-game-router/cmd/mini-game-router/main.go", "Go", 0, -14, 0, 0, 0, -14
"/data/home/ziruigao/src/mini-game-router/core/balancer/balancer.go", "Go", 0, -23, 0, 0, -5, -28
"/data/home/ziruigao/src/mini-game-router/core/balancer/balancerPrototype.go", "Go", 0, 39, 0, 0, 6, 45
"/data/home/ziruigao/src/mini-game-router/core/balancer/consistentHashBalancer.go", "Go", 0, 14, 0, 0, 2, 16
"/data/home/ziruigao/src/mini-game-router/core/balancer/myBalancer.go", "Go", 0, 98, 0, 0, 14, 112
"/data/home/ziruigao/src/mini-game-router/core/balancer/randomBalancer.go", "Go", 0, 6, 0, 0, 2, 8
"/data/home/ziruigao/src/mini-game-router/core/balancer/weightBalancer.go", "Go", 0, 72, 0, 0, 19, 91
"/data/home/ziruigao/src/mini-game-router/core/config/config.go", "Go", 0, 18, 0, 0, 3, 21
"/data/home/ziruigao/src/mini-game-router/core/etcd/discovery.go", "Go", 0, 40, 0, 0, 8, 48
"/data/home/ziruigao/src/mini-game-router/core/etcd/etcdServer/etcd.go", "Go", 0, -29, 0, 0, -6, -35
"/data/home/ziruigao/src/mini-game-router/core/etcd/register.go", "Go", 0, 1, 0, 0, 0, 1
"/data/home/ziruigao/src/mini-game-router/core/proxy/sidecar/sidecar.go", "Go", 0, -13, 0, 0, -1, -14
"/data/home/ziruigao/src/mini-game-router/core/proxyless/matcher/matcher.go", "Go", 0, -134, 0, 0, -37, -171
"/data/home/ziruigao/src/mini-game-router/core/proxyless/type/type.go", "Go", 0, -4, 0, 0, -2, -6
"/data/home/ziruigao/src/mini-game-router/core/router/router.go", "Go", 0, 23, 0, 0, 2, 25
"/data/home/ziruigao/src/mini-game-router/core/stateful/stateful.go", "Go", 0, 58, 0, 0, 11, 69
"/data/home/ziruigao/src/mini-game-router/demo/client/client.go", "Go", 0, 32, 0, 0, 4, 36
"/data/home/ziruigao/src/mini-game-router/demo/server/server.go", "Go", 0, 20, 0, 0, 4, 24
"/data/home/ziruigao/src/mini-game-router/go.mod", "Go Module File", 6, 0, 0, 0, 0, 6
"/data/home/ziruigao/src/mini-game-router/go.sum", "Go Checksum File", 0, 0, 12, 0, 0, 12
"Total", "-", 6, 204, 12, 0, 24, 246